1111111111111
10000C0000001
10000000C0001
1E00000000001
1111111111111
