1111111111111111111111111111111111
1110E0000000C000000000000C00000111
110000000000000E00C000000000000011
11000000C0000000000000000000000011
111000000000000P00000000C0000001111
1111111111111111111111111111111111
