1111111111111111111111111
1110000000000000000000111
10000000P00000C0000000011
1000C000000000000000C0001
100000000000E0000000000011111
110000000C0000000C0000011
1110000000000000000000111
1111111111111111111111111
